 0  0  0  0  0  0  0  0  0 19 11 11 11 25 11 11 11 11 11 11 11 11 11 11 11 11 11 11 11 11 11 21  0  0  0  0  0  0  0  0 
 0  0  0  0  0  0 19 11 11 16 10 9 10 37 9 10 10 9 10 10 10 10 10 10 10 10 10 9 10 10 10 18 11 11 21  0  0  0  0  0 
 0  0  0  0  0  0 13 10 10 10 2 2 2 38 2 2 2 2 2 2 2 2 2 2 2 2 2 2 2 2 2 10 9 10 14  0  0  0  0  0 
 0  0  0  0  0  0 13 2 2 2 2 2 3 2 2 2 2 2 2 2 2 2 3 2 2 2 2 2 2 2 2 2 2 2 14  0  0  0  0  0 
 0  0  0 19 11 11 16 2 2 2 2 2 2 2 2 3 2 2 2 2 2 2 2 2 2 3 2 2 2 2 2 2 2 2 18 11 21  0  0  0 
 0  0  0 13 10 9 10 2 2 2 2 2 2 2 2 2 2 2 2 2 2 2 2 2 2 2 2 2 4 5 2 2 2 2 10 10 14  0  0  0 
 0  0  0 13 2 2 2 3 2 2 2 2 2 2 2 2 2 2 3 2 2 2 2 2 2 2 2 2 6 7 2 2 2 2 2 2 14  0  0  0 
19 11 11 16 2 2 2 2 2 2 2 2 2 3 2 2 2 2 2 2 2 2 3 2 2 2 2 2 2 2 3 2 2 2 2 2 18 25 11 21 
13 10 10 10 2 3 2 2 2 2 2 2 2 2 2 2 2 2 2 2 2 2 2 2 2 2 2 2 2 2 2 2 2 2 2 2 10 37 10 14 
13 2 2 2 2 2 2 2 2 2 2 2 2 2 2 2 2 2 3 2 2 2 2 2 2 2 3 2 2 2 2 2 2 3 2 2 2 38 2 14 
13 2 2 2 2 2 2 2 2 2 2 2 2 2 2 2 2 2 2 2 2 2 2 2 2 2 2 2 2 2 2 2 2 2 2 2 2 2 2 14 
13 2 2 2 2 2 3 2 2 2 2 2 2 3 3 2 2 2 2 2 2 2 2 2 2 2 2 2 2 2 2 2 2 3 2 2 2 2 2 14 
28 24 24 30 2 2 2 2 2 2 2 2 2 2 2 2 2 3 2 2 2 2 2 2 2 3 2 3 2 2 2 2 2 2 2 2 31 24 24 29 
 0  0  0 13 2 2 2 2 2 2 2 3 2 2 4 5 2 2 2 2 3 2 2 2 2 2 2 2 2 2 3 2 2 2 2 2 14  0  0  0 
 0  0  0 28 24 24 30 2 2 2 2 2 2 2 6 7 2 2 2 2 2 2 2 2 2 2 2 2 2 2 2 2 2 31 24 24 29  0  0  0 
 0  0  0  0  0  0 13 2 2 2 3 2 2 2 2 3 2 2 2 2 2 2 2 3 2 3 2 2 2 2 2 2 2 14  0  0  0  0  0  0 
 0  0  0  0  0  0 13 2 2 2 2 2 2 3 2 2 3 2 2 2 2 2 2 2 2 2 2 2 2 2 2 2 2 14  0  0  0  0  0  0 
 0  0  0  0  0  0 28 24 24 30 2 2 2 2 2 2 2 2 3 2 2 2 2 2 2 2 3 2 2 2 31 24 24 29  0  0  0  0  0  0 
 0  0  0  0  0  0  0  0  0 13 2 2 2 2 2 2 2 2 2 2 2 2 2 2 2 2 2 2 2 2 14  0  0  0  0  0  0  0  0  0 
 0  0  0  0  0  0  0  0  0 28 24 24 24 24 24 24 24 24 24 24 24 24 24 24 24 24 24 24 24 24 29  0  0  0  0  0  0  0  0  0 

336 144 1584 144 1680 288 192 336 1536 720 240 624 384 768 576 864 1200 96 1632 624  -1 -1
432 384 480 720 1200 768 1584 480 1152 288 720 192 624 768 960 816 1440 624 864 816 336 480 912 480 1296 480 1200 96 -1 -1
528 240 528 720 1392 192 1440 720 480 528 1392 528 672 240 1200 240 720 672 1248 672 -1 -1