19 11 32 11 11 32 11 11 32 11 11 32 11 11 32 11 11 32 11 11 11 11 32 11 11 32 11 11 32 11 11 32 11 11 32 11 11 32 11 21 
13 10 33 10 10 33 10 10 33 10 10 33 10 10 33 10 10 33 10 10 10 10 33 10 10 33 10 10 33 10 10 33 10 10 33 10 10 33 10 14 
13 2 34 2 2 34 2 2 34 2 2 34 2 2 34 2 2 34 2 2 2 2 34 2 2 34 2 2 34 2 2 34 2 2 34 2 2 34 2 14 
13 2 2 2 2 2 2 2 2 2 2 2 2 2 2 2 2 2 2 2 2 2 2 2 2 2 2 2 2 2 2 2 2 2 2 2 2 2 2 14 
13 2 2 2 2 2 2 2 2 2 2 2 2 2 2 2 2 2 2 2 2 2 2 2 2 2 2 2 2 2 2 2 2 2 2 2 2 2 2 14 
13 2 2 2 2 2 2 2 2 2 2 2 2 2 2 2 2 2 2 2 2 2 2 2 2 2 2 2 2 2 2 2 2 2 2 2 2 2 2 14 
28 24 24 24 30 2 2 2 2 2 2 2 2 2 2 2 2 2 2 2 2 2 2 2 2 2 2 2 2 2 2 2 2 2 2 31 24 24 24 29 
19 11 11 11 16 2 2 2 2 2 2 2 2 2 2 2 2 2 2 2 2 2 2 2 2 2 2 2 2 2 2 2 2 2 2 18 11 11 11 21 
13 10 10 35 10 2 2 2 2 2 2 2 2 2 2 2 2 2 2 2 2 2 2 2 2 2 2 2 2 2 2 2 2 2 2 10 35 10 10 14 
13 2 2 36 2 2 2 2 2 2 2 2 2 2 2 2 2 2 2 2 2 2 2 2 2 2 2 2 2 2 2 2 2 2 2 2 36 2 2 14 
13 2 2 2 2 2 2 2 2 2 2 2 2 2 2 2 2 2 2 2 2 2 2 2 2 2 2 2 2 2 2 2 2 2 2 2 2 2 2 14 
13 2 2 2 2 2 2 2 2 2 2 2 2 2 2 2 2 2 2 2 2 2 2 2 2 2 2 2 2 2 2 2 2 2 2 2 2 2 2 14 
28 24 24 24 24 24 24 24 2 2 2 2 2 2 2 2 2 2 2 2 2 2 2 2 2 2 2 2 2 2 2 2 31 24 24 24 24 24 24 29 
0 0 0 0 0 0 0 13 2 2 2 2 2 2 2 2 2 2 2 2 2 2 2 2 2 2 2 2 2 2 2 2 14 0 0 0 0 0 0 0 
0 0 0 0 0 0 0 28 24 24 30 2 2 2 2 2 2 2 2 2 2 2 2 2 2 2 2 2 2 31 24 24 29 0 0 0 0 0 0 0 
0 0 0 0 0 0 0 0 0 0 13 2 2 2 2 2 2 2 2 2 2 2 2 2 2 2 2 2 2 14 0 0 0 0 0 0 0 0 0 0 
0 0 0 0 0 0 0 0 0 0 13 2 2 2 2 2 2 2 2 2 2 2 2 2 2 2 2 2 2 14 0 0 0 0 0 0 0 0 0 0 
0 0 0 0 0 0 0 0 0 0 13 2 2 2 2 2 2 2 2 2 2 2 2 2 2 2 2 2 2 14 0 0 0 0 0 0 0 0 0 0 
0 0 0 0 0 0 0 0 0 0 13 2 2 2 2 2 2 2 2 2 2 2 2 2 2 2 2 2 2 14 0 0 0 0 0 0 0 0 0 0 
0 0 0 0 0 0 0 0 0 0 28 24 24 24 24 24 24 24 24 24 24 24 24 24 24 24 24 24 24 29 0 0 0 0 0 0 0 0 0 0