0 0 0 0 0 0 0 0 0 0 0 0 0 0 0 0 0 19 11 11 11 11 21 0 0 0 0 0 0 0 0 0 0 0 0 0 0 0 0 0
0 0 0 0 0 0 0 0 0 0 0 0 0 0 0 0 0 13 10 10 10 10 14 0 0 0 0 0 0 0 0 0 0 0 0 0 0 0 0 0 
0 0 0 0 0 0 0 0 0 0 0 0 0 0 0 0 0 13 2 2 2 2 14 0 0 0 0 0 0 0 0 0 0 0 0 0 0 0 0 0 
0 0 0 0 0 0 0 0 0 0 0 0 0 0 0 0 0 13 2 2 2 2 14 0 0 0 0 0 0 0 0 0 0 0 0 0 0 0 0 0 
0 0 0 0 0 0 0 0 0 0 0 0 0 0 0 0 0 13 2 3 2 2 14 0 0 0 0 0 0 0 0 0 0 0 0 0 0 0 0 0 
0 0 0 0 0 0 0 0 0 0 0 0 0 0 0 0 0 13 2 2 2 2 14 0 0 0 0 0 0 0 0 0 0 0 0 0 0 0 0 0 
19 25 11 11 25 11 11 25 11 11 25 11 11 25 11 11 25 16 2 2 2 2 18 25 11 11 25 11 11 25 11 11 11 11 11 25 11 11 25 21
13 26 10 9 26 10 9 26 9 10 26 10 9 26 9 10 26 10 2 2 2 2 10 26 10 10 26 10 10 26 10 9 10 10 10 26 9 10 26 14
13 27 2 2 27 2 2 27 2 2 27 2 2 27 2 2 27 2 2 2 2 2 2 27 2 2 27 2 2 27 2 2 2 2 2 27 2 2 27 14
13 2 2 3 2 2 2 2 2 2 2 2 2 2 3 2 2 2 2 4 5 2 2 2 2 3 2 2 2 2 2 2 2 2 3 2 2 2 2 14 
13 2 2 2 2 3 2 2 2 3 2 2 3 2 2 2 2 2 2 6 7 3 2 2 2 2 2 2 2 2 2 2 2 4 5 2 2 3 2 14 
13 2 2 2 2 2 2 2 2 2 2 2 2 2 2 2 2 2 2 2 2 2 2 2 2 2 2 3 2 2 2 2 2 6 7 2 2 2 2 14 
28 24 24 24 24 24 24 24 24 24 24 24 24 24 24 24 24 30 2 2 2 2 31 24 24 24 24 24 24 24 24 24 24 24 24 24 24 24 24 29 
0 0 0 0 0 0 0 0 0 0 0 0 0 0 0 0 0 13 2 2 2 2 14 0 0 0 0 0 0 0 0 0 0 0 0 0 0 0 0 0 
0 0 0 0 0 0 0 0 0 0 0 0 0 0 0 0 0 13 2 3 2 2 14 0 0 0 0 0 0 0 0 0 0 0 0 0 0 0 0 0 
0 0 0 0 0 0 0 0 0 0 0 0 0 0 0 0 0 13 2 2 2 3 14 0 0 0 0 0 0 0 0 0 0 0 0 0 0 0 0 0 
0 0 0 0 0 0 0 0 0 0 0 0 0 0 0 0 0 13 2 2 2 2 14 0 0 0 0 0 0 0 0 0 0 0 0 0 0 0 0 0 
0 0 0 0 0 0 0 0 0 0 0 0 0 0 0 0 0 13 2 3 2 2 14 0 0 0 0 0 0 0 0 0 0 0 0 0 0 0 0 0 
0 0 0 0 0 0 0 0 0 0 0 0 0 0 0 0 0 13 2 2 2 2 14 0 0 0 0 0 0 0 0 0 0 0 0 0 0 0 0 0 
0 0 0 0 0 0 0 0 0 0 0 0 0 0 0 0 0 28 24 24 24 24 29 0 0 0 0 0 0 0 0 0 0 0 0 0 0 0 0 0

-1 -1
960 384 864 384 912 384 1008 384 864 576 1008 576 912 336 960 240 912 576 960 576 480 480 240 480 624 432 768 480 816 528 1056 480 1056 432 1296 432 1536 432 1680 432 1536 480 1728 480 912 192 1776 432 1776 528 960 768 912 768 -1 -1
-1 -1
