0 0 0 0 0 0 0 0 0 0 0 0 0 0 0 0 0 19 11 11 11 11 21 0 0 0 0 0 0 0 0 0 0 0 0 0 0 0 0 0
0 0 0 0 0 0 0 0 0 0 0 0 0 0 0 0 19 16 10 10 10 9 18 21 0 0 0 0 0 0 0 0 0 0 0 0 0 0 0 0 
0 0 0 0 0 0 0 0 0 0 0 0 0 0 19 25 16 10 2 2 2 2 10 18 25 21 0 0 0 0 0 0 0 0 0 0 0 0 0 0 
0 0 0 0 0 0 0 0 19 11 11 11 11 25 16 26 10 2 2 2 2 2 2 9 26 18 25 11 11 11 11 21 0 0 0 0 0 0 0 0
0 0 0 19 11 11 11 25 16 9 9 10 10 26 10 27 2 2 2 2 2 2 2 2 27 10 26 10 10 10 10 18 25 11 11 11 21 0 0 0 
0 0 19 16 10 10 10 26 10 2 2 2 2 27 2 2 2 2 2 2 2 2 2 2 2 2 27 2 2 2 2 10 26 10 10 9 18 21 0 0 
0 19 16 10 2 2 2 27 2 2 2 2 2 2 2 2 2 2 2 3 2 2 2 2 2 2 2 2 2 2 2 2 27 2 2 2 10 18 21 0 
19 16 10 2 2 3 2 2 2 2 2 2 3 2 2 2 2 2 2 2 2 2 2 3 2 2 2 2 2 2 2 2 3 2 2 2 2 9 18 21 
13 9 2 2 2 2 2 2 4 2 2 2 2 2 2 2 2 2 2 2 2 2 2 2 2 2 2 2 3 2 2 2 2 2 2 2 2 2 10 14 
13 2 2 2 2 2 2 3 2 2 3 2 2 2 2 2 2 2 2 2 2 2 2 2 2 2 2 2 3 2 2 2 2 2 2 3 2 2 2 14
13 2 2 2 2 2 2 3 2 2 5 2 2 2 2 2 2 3 2 2 2 2 2 2 2 2 2 2 2 2 2 2 2 2 2 2 2 2 2 14
13 2 2 2 2 2 2 2 2 2 5 2 2 2 2 2 2 2 2 2 2 2 2 2 2 2 2 2 2 4 5 2 2 2 2 2 2 2 2 14
28 24 24 30 2 2 2 2 6 7 2 2 2 2 2 2 2 2 2 2 2 2 2 2 3 2 2 2 2 6 7 2 2 2 3 2 31 24 24 29 
0 0 0 13 2 2 2 2 2 2 2 2 2 2 2 2 2 2 2 2 3 2 2 2 2 2 2 2 2 2 2 2 2 2 2 2 14 0 0 0 
0 0 0 13 2 2 2 2 2 2 4 5 2 2 3 2 2 2 2 2 2 2 2 2 2 2 2 2 2 2 2 2 2 2 2 2 14 0 0 0 
0 0 0 13 2 2 3 2 2 2 6 7 2 2 2 2 2 2 2 2 2 2 2 2 2 2 2 2 2 2 3 2 2 2 2 2 14 0 0 0 
0 0 0 13 2 2 2 2 2 2 2 2 2 2 2 2 2 2 2 2 2 2 2 2 2 2 2 2 3 2 2 2 2 2 2 2 14 0 0 0 
0 0 0 28 24 24 24 24 30 2 2 2 2 2 2 2 2 2 2 2 3 2 2 2 2 2 2 2 2 2 2 2 31 24 24 24 29 0 0 0 
0 0 0 0 0 0 0 0 28 24 24 24 24 24 24 30 2 2 2 2 2 2 2 2 31 24 24 24 24 24 24 24 29 0 0 0 0 0 0 0 
0 0 0 0 0 0 0 0 0 0 0 0 0 0 0 28 24 24 24 24 24 24 24 24 29 0 0 0 0 0 0 0 0 0 0 0 0 0 0 0 

-1 -1
912 336 960 336 912 624 960 624 672 480 672 528 1152 480 1152 528 1584 384 528 336 240 576 288 720 576 672 1344 336 1392 672 1200 816 1056 864 1632 672 1488 816 1632 768 1152 288 720 288 192 384 -1 -1
480 288 1440 288 288 720 1440 768 528 528 1440 480 672 624 1200 624 720 336 960 480 -1 -1
