0 0 0 0 19 11 11 11 11 11 11 21 0 0 0 19 11 11 25 11 11 25 11 11 21 0 0 0 19 11 11 11 11 11 11 21 0 0 0 0
19 11 11 25 16 10 9 10 10 10 10 18 11 25 11 16 10 10 37 10 10 37 10 10 18 11 25 11 16 10 10 10 10 9 10 18 25 11 11 21 
13 9 10 26 10 2 2 2 2 2 2 10 10 26 10 9 2 2 38 2 2 38 2 2 10 10 26 10 10 2 2 2 2 2 2 10 26 9 10 14 
13 2 2 27 2 2 2 2 3 2 2 2 2 27 2 2 2 2 2 2 2 2 2 2 2 2 27 2 2 2 2 2 2 2 2 2 27 2 2 14 
13 2 2 2 2 2 2 2 2 2 2 2 2 2 2 2 2 2 2 2 2 2 2 2 2 2 2 2 2 2 2 3 2 2 2 2 2 2 2 14 
28 24 30 2 2 2 2 2 2 2 2 3 2 2 2 2 3 2 5 2 2 2 2 3 2 5 2 2 2 2 2 2 2 2 2 2 2 31 24 29 
0 0 13 2 2 2 2 2 2 2 19 11 11 11 11 11 11 25 11 11 11 11 25 11 11 11 11 11 11 21 2 2 2 2 2 2 2 14 0 0 
19 25 16 2 2 2 2 2 2 6 13 9 10 10 10 10 10 26 10 9 10 10 26 10 10 10 10 9 10 14 5 2 2 2 2 2 2 18 25 21 
13 26 10 2 2 2 2 2 2 2 16 2 2 2 2 2 2 27 2 2 2 2 27 2 2 2 2 2 2 18 2 2 2 2 2 2 2 10 26 14 
13 27 2 2 2 2 2 2 2 2 10 2 2 2 2 2 2 2 2 2 2 2 2 2 2 2 2 2 2 10 2 3 2 2 2 2 2 2 27 14 
13 2 2 2 2 2 2 2 2 2 2 2 2 2 2 2 2 2 2 2 2 2 2 2 2 2 2 2 2 2 2 2 2 2 2 2 3 2 2 14 
13 2 3 2 2 4 5 2 2 2 2 2 2 2 2 2 2 2 2 4 5 2 2 2 2 2 2 2 2 2 2 2 2 2 2 2 2 2 2 14 
13 2 2 2 2 6 7 2 2 2 30 2 2 2 2 2 2 2 2 6 7 2 2 2 2 2 2 2 2 31 2 2 2 2 2 2 2 2 2 14 
13 2 2 2 2 2 2 2 2 2 13 2 2 2 2 2 2 2 2 2 2 2 2 2 2 2 2 2 2 14 3 2 2 2 3 2 2 2 2 14 
13 2 2 2 2 2 2 2 2 2 28 24 24 24 24 24 24 24 24 24 24 24 24 24 24 24 24 24 24 29 5 2 2 2 2 2 2 2 2 14 
13 2 2 2 2 2 2 2 2 6 0 0 0 0 0 0 0 0 0 0 0 0 0 0 0 0 0 0 0 0 2 2 2 2 2 2 2 2 2 14 
13 2 2 2 2 2 2 2 2 2 3 2 2 7 3 2 3 3 2 7 2 2 3 2 2 7 2 2 2 2 2 2 2 2 2 3 2 2 2 14 
28 24 30 2 2 2 2 2 3 2 2 2 2 2 2 2 2 2 2 2 2 2 2 2 2 2 2 2 2 4 5 2 2 2 2 2 2 31 24 29 
0 0 13 2 2 2 2 2 2 2 2 2 2 2 2 2 2 2 2 2 2 2 2 2 2 2 2 2 2 6 7 2 2 2 2 2 2 14 0 0 
0 0 28 24 24 24 24 24 24 24 24 24 24 24 24 24 24 24 24 24 24 24 24 24 24 24 24 24 24 24 24 24 24 24 24 24 24 29 0 0 

48 144 1824 144 1104 96 768 96 -1 -1
480 480 1392 480 240 192 1584 192 1584 672 528 576 1344 576 912 384 288 816 144 864 1824 768 -1 -1
288 192 1632 192 240 816 1632 768 768 480 1104 480 528 192 1344 192 1536 480 288 480 -1 -1
